1111000011111111
1111000000001111
1111000110001111
1111000000001111
1001100110011111
0000000000000000
